ab	Abkhazian
ace	Achinese
ach	Acoli
ada	Adangme
aa	Afar
afh	Afrihili
af	Afrikaans
afa	Afro-Asiatic (Other)
aka	Akan
akk	Akkadian
sq	Albanian
ale	Aleut
alg	Algonquian languages
tut	Altaic (Other)
am	Amharic
apa	Apache languages
ar	Arabic
arc	Aramaic
arp	Arapaho
arn	Araucanian
arw	Arawak
hy	Armenian
art	Artificial (Other)
as	Assamese
ath	Athapascan languages
aus	Australian languages
map	Austronesian (Other)
ava	Avaric
ae	Avestan
awa	Awadhi
ay	Aymara
az	Azerbaijani
ban	Balinese
bat	Baltic (Other)
bal	Baluchi
bam	Bambara
bai	Bamileke languages
bad	Banda
bnt	Bantu (Other)
bas	Basa
ba	Bashkir
eu	Basque
btk	Batak (Indonesia)
bej	Beja
be	Belarusian
bem	Bemba
bn	Bengali
ber	Berber (Other)
bho	Bhojpuri
bh	Bihari
bik	Bikol
bin	Bini
bi	Bislama
bs	Bosnian
bra	Braj
br	Breton
bug	Buginese
bg	Bulgarian
bua	Buriat
my	Burmese
cad	Caddo
car	Carib
ca	Catalan
cau	Caucasian (Other)
ceb	Cebuano
cel	Celtic (Other)
cai	Central American Indian (Other)
chg	Chagatai
cmc	Chamic languages
ch	Chamorro
ce	Chechen
chr	Cherokee
chy	Cheyenne
chb	Chibcha
ny	Chichewa; Nyanja
zh	Chinese
chn	Chinook jargon
chp	Chipewyan
cho	Choctaw
cu	Church Slavic
chk	Chuukese
cv	Chuvash
cop	Coptic
kw	Cornish
co	Corsican
cre	Cree
mus	Creek
crp	Creoles and pidgins (Other)
cpe	Creoles and pidgins, English based (Other)
cpf	Creoles and pidgins, French-based (Other)
cpp	Creoles and pidgins, Portuguese-based (Other)
hr	Croatian
cus	Cushitic (Other)
cs	Czech
dak	Dakota
da	Danish
day	Dayak
del	Delaware
din	Dinka
div	Divehi
doi	Dogri
dgr	Dogrib
dra	Dravidian (Other)
dua	Duala
nl	Dutch
dum	Dutch, Middle (ca.1050-1350)
dyu	Dyula
dz	Dzongkha
efi	Efik
egy	Egyptian (Ancient)
eka	Ekajuk
elx	Elamite
en	English
enm	English, Middle (1100-1500)
ang	English, Old (ca.450-1100)
eo	Esperanto
et	Estonian
ewe	Ewe
ewo	Ewondo
fan	Fang
fat	Fanti
fo	Faroese
fj	Fijian
fi	Finnish
fiu	Finno-Ugrian (Other)
fon	Fon
fr	French
frm	French, Middle (ca.1400-1600)
fro	French, Old (842-ca.1400)
fy	Frisian
fur	Friulian
ful	Fulah
gaa	Ga
gd	Gaelic (Scots)
gl	Gallegan
lug	Ganda
gay	Gayo
gba	Gbaya
gez	Geez
ka	Georgian
de	German
gmh	German, Middle High (ca.1050-1500)
goh	German, Old High (ca.750-1050)
gem	Germanic (Other)
gil	Gilbertese
gon	Gondi
gor	Gorontalo
got	Gothic
grb	Grebo
grc	Greek, Ancient (to 1453)
el	Greek, Modern (1453-)
gn	Guarani
gu	Gujarati
gwi	Gwich´in
hai	Haida
ha	Hausa
haw	Hawaiian
he	Hebrew
hz	Herero
hil	Hiligaynon
him	Himachali
hi	Hindi
ho	Hiri Motu
hit	Hittite
hmn	Hmong
hu	Hungarian
hup	Hupa
iba	Iban
is	Icelandic
ibo	Igbo
ijo	Ijo
ilo	Iloko
inc	Indic (Other)
ine	Indo-European (Other)
id	Indonesian
ia	Interlingua (International Auxiliary Language Association)
ie	Interlingue
iu	Inuktitut
ik	Inupiaq
ira	Iranian (Other)
ga	Irish
mga	Irish, Middle (900-1200)
sga	Irish, Old (to 900)
iro	Iroquoian languages
it	Italian
ja	Japanese
jw	Javanese
jrb	Judeo-Arabic
jpr	Judeo-Persian
kab	Kabyle
kac	Kachin
kl	Kalaallisut
kam	Kamba
kn	Kannada
kau	Kanuri
kaa	Kara-Kalpak
kar	Karen
ks	Kashmiri
kaw	Kawi
kk	Kazakh
kha	Khasi
km	Khmer
khi	Khoisan (Other)
kho	Khotanese
ki	Kikuyu
kmb	Kimbundu
rw	Kinyarwanda
ky	Kirghiz
kv	Komi
kon	Kongo
kok	Konkani
ko	Korean
kos	Kosraean
kpe	Kpelle
kro	Kru
kj	Kuanyama
kum	Kumyk
ku	Kurdish
kru	Kurukh
kut	Kutenai
lad	Ladino
lah	Lahnda
lam	Lamba
lo	Lao
la	Latin
lv	Latvian
lb	Letzeburgesch
lez	Lezghian
ln	Lingala
lt	Lithuanian
nds	Low German; Low Saxon; German, Low; Saxon, Low
loz	Lozi
lub	Luba-Katanga
lua	Luba-Lulua
lui	Luiseno
lun	Lunda
luo	Luo (Kenya and Tanzania)
lus	lushai
mk	Macedonian
mad	Madurese
mag	Magahi
mai	Maithili
mak	Makasar
mg	Malagasy
ms	Malay
ml	Malayalam
mt	Maltese
mnc	Manchu
mdr	Mandar
man	Mandingo
mni	Manipuri
mno	Manobo languages
gv	Manx
mi	Maori
mr	Marathi
chm	Mari
mh	Marshall
mwr	Marwari
mas	Masai
myn	Mayan languages
men	Mende
mic	Micmac
min	Minangkabau
mis	Miscellaneous languages
moh	Mohawk
mo	Moldavian
mkh	Mon-Khmer (Other)
lol	Mongo
mn	Mongolian
mos	Mossi
mul	Multiple languages
mun	Munda languages
nah	Nahuatl
na	Nauru
nv	Navajo
nd	Ndebele, North
nr	Ndebele, South
ng	Ndonga
ne	Nepali
new	Newari
nia	Nias
nic	Niger-Kordofanian (Other)
ssa	Nilo-Saharan (Other)
niu	Niuean
non	Norse, Old
nai	North American Indian
se	Northern Sami
no	Norwegian
nb	Norwegian Bokmål
nn	Norwegian Nynorsk
nub	Nubian languages
nym	Nyamwezi
nyn	Nyankole
nyo	Nyoro
nzi	Nzima
oc	Occitan (post 1500); Provençal
oji	Ojibwa
or	Oriya
om	Oromo
osa	Osage
os	Ossetian; Ossetic
oto	Otomian languages
pal	Pahlavi
pau	Palauan
pi	Pali
pam	Pampanga
pag	Pangasinan
pa	Panjabi
pap	Papiamento
paa	Papuan (Other)
fa	Persian
peo	Persian, Old (ca.600-400 B.C.)
phi	Philippine (Other)
phn	Phoenician
pon	Pohnpeian
pl	Polish
pt	Portuguese
pra	Prakrit languages
pro	Provençal, Old (to 1500)
ps	Pushto
qu	Quechua
rm	Raeto-Romance
raj	Rajasthani
rap	Rapanui
rar	Rarotongan
qaa-qtz	Reserved for local use
roa	Romance (Other)
ro	Romanian
rom	Romany
rn	Rundi
ru	Russian
sal	Salishan languages
sam	Samaritan Aramaic
smi	Sami languages (Other)
sm	Samoan
sad	Sandawe
sg	Sango
sa	Sanskrit
sat	Santali
sc	Sardinian
sas	Sasak
sco	Scots
sel	Selkup
sem	Semitic (Other)
sr	Serbian
srr	Serer
shn	Shan
sn	Shona
sid	Sidamo
sgn	Sign Languages
bla	Siksika
sd	Sindhi
si	Sinhalese
sit	Sino-Tibetan (Other)
sio	Siouan languages
den	Slave (Athapascan)
sla	Slavic (Other)
sk	Slovak
sl	Slovenian
sog	Sogdian
so	Somali
son	Songhai
snk	Soninke
wen	Sorbian languages
nso	Sotho, Northern
st	Sotho, Southern
sai	South American Indian (Other)
es	Spanish
suk	Sukuma
sux	Sumerian
su	Sundanese
sus	Susu
sw	Swahili
ss	Swati
sv	Swedish
syr	Syriac
tl	Tagalog
ty	Tahitian
tai	Tai (Other)
tg	Tajik
tmh	Tamashek
ta	Tamil
tt	Tatar
te	Telugu
ter	Tereno
tet	Tetum
th	Thai
bo	Tibetan
tig	Tigre
ti	Tigrinya
tem	Timne
tiv	Tiv
tli	Tlingit
tpi	Tok Pisin
tkl	Tokelau
tog	Tonga (Nyasa)
to	Tonga (Tonga Islands)
tsi	Tsimshian
ts	Tsonga
tn	Tswana
tum	Tumbuka
tr	Turkish
ota	Turkish, Ottoman (1500-1928)
tk	Turkmen
tvl	Tuvalu
tyv	Tuvinian
tw	Twi
uga	Ugaritic
ug	Uighur
uk	Ukrainian
umb	Umbundu
und	Undetermined
ur	Urdu
uz	Uzbek
vai	Vai
ven	Venda
vi	Vietnamese
vo	Volapük
vot	Votic
wak	Wakashan languages
wal	Walamo
war	Waray
was	Washo
cy	Welsh
wo	Wolof
xh	Xhosa
sah	Yakut
yao	Yao
yap	Yapese
yi	Yiddish
yo	Yoruba
ypk	Yupik languages
znd	Zande
zap	Zapotec
zen	Zenaga
za	Zhuang
zu	Zulu
zun	Zuni
[ based on http://lcweb.loc.gov/standards/iso639-2/bibcodes.html
 at Tue Mar 13 21:52:48 2001]
[Note: doesn't include IANA-registered codes.]
